*******************
*     *           *
**    *           *
*           *   ***
*           *     *
*           *     *
*      ********   *
*****    *        *
*        *       **
*******************
